GGGrGrrrGrrrGrrr
GrGGGGrrGrrrGrrr
GrrrGGGGGrrrGrrr
GrrrGrGGGGrrGrrr
GrrrGrrrGGGrGrrr
GrrrGrrrGrGGGrrr
GrrrGrrrGrrrGGrr
GrrrGrrrGGGrGrGG
GrrrGrrrGrrrGrrr
